########
#####@.#
####.$$#
#### $ #
### .# #
###    #
###  ###
########
;
########
### .###
### @###
#. $.###
# #  ###
# $$ ###
###  ###
########
;
########
#+ $ ###
# $  ###
# #  ###
#  $####
#.# ####
#.  ####
########
;
########
####@ ##
##   $##
## #. ##
##   $##
####.$ #
####  .#
########
;
########
##@ ####
##$$####
# $   ##
# #  .##
#.   ###
### .###
########
;
########
####  .#
####   #
###..$.#
### #$ #
###  $$#
#####@ #
########
;
########
###@  ##
###$# ##
##    ##
## # .##
##.$*  #
####   #
########
;
########
###   ##
#@$   ##
# $$  ##
### #.##
### #.##
###  .##
########
;
########
#####@ #
#####$$#
###  $ #
## ..  #
##   # #
####  .#
########
;
########
####  .#
#### #.#
###   .#
### $# #
## $$  #
## @ ###
########
;
########
##.  ###
##.# ###
##  $###
## #@###
##  $  #
##. $  #
########
;
########
###  ###
###  $@#
### .# #
##  $$ #
##. . ##
##  ####
########
;
########
###@ ###
###$ ###
# $   ##
# #$. ##
#.  . ##
####  ##
########
;
########
####@ ##
#### .##
## $$  #
##   . #
###$#. #
###   ##
########
;
########
####  ##
####  ##
##  $$ #
##.+* .#
## $ # #
####   #
########
;
########
###.@.##
# $$#$##
#      #
### .  #
### *  #
########
;
########
####   #
##. $..#
## # . #
## $$  #
####@$##
####  ##
########
;
########
##  ####
##. .$+#
##   # #
###$$  #
###  *##
###   ##
########
;
#########
####.@. #
### $ $ #
###  $ ##
####  ###
####.$###
####. ###
####  ###
#########
;
#########
#####   #
####    #
####  $##
####$. ##
###+$.###
### $ ###
###. ####
#########
;
########
#  #####
#  @ ###
#  # ###
##.#$  #
#  $   #
#  .####
########
;
########
###  ###
##.$ ###
## # ###
# $ $  #
# ..   #
## @ ###
########
;
########
####.  #
## $ $ #
##.$. ##
##.$# ##
##  #@##
##    ##
########
;
########
###  ###
###    #
###$  .#
###  #.#
## $$#.#
##@$.  #
########
;